1111111111111
10000C00000C1
1CC0111111001
1P0100E000C01
1111111111111