1111111111111
11100C00000C1
1110111111001
1P1100E000C01
1111111111111