1111111111111
11100C00000C1
1100111111001
1P1000E000C01
1111111111111