111111
1000C1
11P101
1E1001
111111
