111111
1P00C1
110001
1EC001
111111
