111111
1000C1
10P001
1E0001
111111
