111111
1P10C1
110001
1E0001
111111
