111111
10P0C1
110101
1E1001
111111
