111111
1P10C1
100001
1E0001
111111
