1111111111111
11C1111111111
1100000000001
1111111111001
1111111111011
1111111111011
1P000000000C1
1111110111111
1000000000001
10000C0100001
1000000000E01
1111111111111