111111
1000C1
11P001
1E1001
111111
